""
INDEX__SECTION	INDEX_SECTION
houdini.hdalibrary	houdini.hdalibrary
Vop_1unityburst	Vop/unityburst
Vop_1unityMinMaxCurve	Vop/unityMinMaxCurve
Vop_1unityparticletemplate	Vop/unityparticletemplate
Vop_1UnityCollisionModule	Vop/UnityCollisionModule
Vop_1UnityCustomDataModule	Vop/UnityCustomDataModule
Vop_1UnityEmissionModule	Vop/UnityEmissionModule
Vop_1UnityExternalForcesModule	Vop/UnityExternalForcesModule
Vop_1UnityForceOverLifetimeModule	Vop/UnityForceOverLifetimeModule
Vop_1UnityInheritVelocityModule	Vop/UnityInheritVelocityModule
Vop_1UnityNoiseModule	Vop/UnityNoiseModule
Vop_1UnityRenderModule	Vop/UnityRenderModule
Vop_1UnityRotationBySpeedModule	Vop/UnityRotationBySpeedModule
Vop_1UnityRotationOverLifetimeModule	Vop/UnityRotationOverLifetimeModule
Vop_1UnityShapeModule	Vop/UnityShapeModule
Vop_1UnitySizeBySpeedModule	Vop/UnitySizeBySpeedModule
Vop_1UnityTextureSheetAnimationModule	Vop/UnityTextureSheetAnimationModule
Vop_1UnityTrailsModule	Vop/UnityTrailsModule
Vop_1UnityColorBySpeedModule	Vop/UnityColorBySpeedModule
Vop_1UnityColorOverLifetimeModule	Vop/UnityColorOverLifetimeModule
Vop_1UnitySizeOverLifetimeModule	Vop/UnitySizeOverLifetimeModule
Vop_1UnityLimitVelocityOverLifetimeModule	Vop/UnityLimitVelocityOverLifetimeModule
Vop_1UnityEmitterModule	Vop/UnityEmitterModule
Vop_1UnityVelocityOverLifetimeModule	Vop/UnityVelocityOverLifetimeModule
Vop_1UnityColorToConstant	Vop/UnityColorToConstant
Vop_1UnityRampToCurve	Vop/UnityRampToCurve
Vop_1UnityFloatToConstant	Vop/UnityFloatToConstant
Vop_1UnityRampToColor	Vop/UnityRampToColor
Vop_1UnityRampToCurveRange	Vop/UnityRampToCurveRange
Vop_1UnityFloatToConstantRange	Vop/UnityFloatToConstantRange
Vop_1UnityIntToConstantRange	Vop/UnityIntToConstantRange
Vop_1UnityEmitterModule__ParticleTemplate	Vop/UnityEmitterModule_ParticleTemplate
